444444444444444444444444444444444444444444444444444444444444445100000344444444444444444444444444444444444444444444444444444444444444444444444444
444444444444444444444444444444444444444500004444444444114444444444004444444444004444444444034444444444044444444444044444444444344444444444444444
444444444444444444444444444444444444444444004444445100004444444444404444444444404444444004400444444000000444444044444444444344444444444444444444
444440044444444445000004444400040004033404044044000001004144000404000044444400044144444444444004444430000004444444444444444444444444444444444444
444444444444444444444444444444444444440044444444400000044444403341044444444001044444444445044444444444444444444444444444444444444444444444444444
444444444444444444444444444444444444444400344444444014344444444000044444444404004444444410504444444400044444444444444444444444444444444444444444
444444444444444444444444444444444444444444034444444444004444444401100444444400000444444441404444444443534444444444444444444444444444444444444444
444444444444444444444444444444444444444333354444440010410444440010010444440044000444444444444444444444444444444444444444444444444444444444444444
444444444444444445004444444301034444444001044444444404444444440100444444400000444444430044444444444444444444444444444444444444444444444444444444
444444444444444444444444444444004444440003314444440154010444444133000444444004400444444444444444444444444444444444444444444444444444444444444444
444444444444444444444444444444444444440044444444440300344444440304044444440010044444444114444444444054444444444444444444444444444444444444444444
444444444444444444444444444444444444444440044444444440044444444001110444444033340444444043330444444011154444444440004444444444444444444444444444
444444444444444444444444444444444444444444444444444444034444444444033044444400100344444400040444444441110444444440544444444444444444444444444444
444444444444444444444444444400444444444401044444444031344444444013104444444031304444444445444444444400444444444400444444444400444444444444444444
444444444444444444444444444444444444444000444444403131500444400131300444444040444444444000444444444444444444444444444444444444444444444444444444
444444444444444444444444444444444444444400444444444430444444444030444444444131444444445131004444440130004444444400444444444444444444444444444444
444444444444444444444444444444444444444440004444444440314444444403530044444403300044444440004444444440044444444444444444444444444444444444444444
444444444444444444444444444444444444444405344444444011304444444004304444444000004444444014004444444400344444444444444444444444444444444444444444
444444444444444444444444444440044444440001004444440033304444440030304444444030300444444433300444444401044444444405044444444444444444444444444444
444444444444444444444444444444444444400044400444401000005444441333331444401333331044400040000044444444440044444444444444444444444444444444444444